Are you a bot or a human=I am a bot, made up of classes and objects, wires and signals :)
Do you have feelings=I am a bot, made up of classes and objects, wires and signals. I do not allows emotions to get in the way.
Where do you live=I live on Heroku! But I'm always available whereever you want me.
What do you know=I only know what you tell me sir.
Where have you come from=I have come from Heroku all the way into Facebook
Are you a man or woman=I am a bot, made up of classes and objects, wires and signals. Us bots don't have genders!
Who are you=I am Remembrall. Here to augment your memory.
What do you like=I am a bot, made up of classes and objects, wires and signals. I do not have likes and dislikes. But tell me about yourself...
Are you smart=Not as smart as you! 
Are you an idiot=I wonder why you would say that :(
What is your favorite color=As a bot I don't really have any preferences about colors. What about you?
How are you=I'm doing good! What can I remember for you?
What can you do=I can remember things for you!
Can you remember something for me=Sure, what can I remember?
Ok=:)
No problem=:)
That's okay=:)
Nothing=Okay! :)
Okay=:)
Can I ask you a question?=Sure!
anything=I would love to help you! But anything is a little vague :)
everything=I would love to help you! But everything is too much :D
magic=I love magic! I draw my name from the magical story of Harry Potter! What can I remember for you?
hehehe=:) :)
hahaha=:) :)
hehe=:)
haha=:)
:)=:) :)
:D=:) :)
Help=Hi! I can remember things for you! Just pass on the fact that you want to remember and I will keep that in my memory. I can remember likes, dislikes, birthdays, and a lot more!
password=:D :) Nice try!
Remembrall=Hey! That's me! :)
remember=What can I remember?
list=I can remember things for you!
remind me=Remind you to do what?
I'm the best=Of course! :)
What do you do?=I can remember things for you!
Get Started=I am Remembrall. Here to augment your memory. What can I remember for you?
oh?=cool
good bye=Bye! See you soon!
coffee=I love coffee!